XXXXXXXXXXXXXX
X------------X
X-X--XX---X--X
X-X-X--X--X--X
X-X-X---XX---X
X-X----------X
X-X-------X--X
X-X-XXXXXXX--X
X-X-------X--X
X-X----------X
X-X-------X--X
X-X-XXXXXXX--X
X-X-------X--X
X-X----------X
X-X--XXXXXX--X
X-X-X--------X
X-X-X--------X
X-X--XXXXXX--X
X-X--------P-X
X-X--XX-XX---X
X-X-X--X--X--X
X-X-X--X--X--X
X-X-XXXXXXX--X
X------------X
XXXXXXXXXXXXXX

//BUTTS 